########################################################
#..*...................................#######,.....*..#
#..........#####...........#####.......#######.........#
#..........#####...........#####.......#######.........#
#..........#####...........#####.......#######.........#
#......................................#######.........#
#.,....................................#######.........#
###################....................#######.........#
###################....................#######.........#
###################....................................#
###################............................#########
#..............................................#########
#.....................############.............#########
%.....................############.............#########
###########...........############.....................#
###########........................................*...#
###########.....................,......................#
#...........................########...................#
#...........................########...................#
###########.................########...................#
###########*...........................................#
###########,...........................................#
########################################################