########################################################
#..*..........#................#########..............,#
#.............#................#########...............#
#.............#,...............#########...............#
#.............#................#########...............#
#.............#########........#########...............#
#.....................#................................#
####..................#.*......................#########
####..................#######..................#########
####...........................................#########
#############.....................########.....#########
#############.....................########.....#########
#############.....................########.....#########
#############..................................#########
#.......................########.......................#
#.......................#,.....#...................*...#
#.......................#......#...............#########
#.......................#......##########......#########
#.......................#...............#......#########
############......#######...............#..............#
############...........,#..............................#
############........*...#..............................#
############################################## % #######