################################       #################
#  *          #                #       #               #
#             #                #       #               #
#             #                #       #               #
#             #                #       #               #
#             #########        #########               #         
#                     #                                #
#### 		      # *                      #########
   #                  #######                  #
   #                                           #
   ##########                     ########     #
            #                     #      #     #
            #                     ########     #
#############                                  ##########
#                       ########                        #
#                       #      #                   *    #
#                       #      #               ##########
#                       #      ##########      #
#                       #         	#      ##########
############		#######         #               #
	   #				#	        #
           #			*	#	        #
           ################################### % ########



        