########################################     ###########
#  *                                   #     #      *  #
#          #####           #####       #     #         #
#          #   #           #   #       #     #         #
#          #####           #####       #     #         #
#                                      #     #         #
#                                      #     #         #
###################                    #     #         #
                  #                    #######         #
                  #                                    #
###################                            #########
#                                              #
#                     ############             #
 %                     #          #            #########
###########           ############                     #
          #                                        *   #
###########                                            #
#                           ########         	       #
#                           #      #         	       #
###########		    ########	               #
	   #*					       #
           #					       #
           #############################################



                                               